####################
#o................o#
#.#.############.#.#
#.#.#..........#.#.#
#.#.#.#.####.#.#.#.#
#.#.#.#.####.#.#.#.#
#.#.#.#......#.#.#.#
#.#.#.#.####.#.#.#.#
#...#.#......#.#...#
#.#.#.#.####.#.#.#.#
#.#...#......#...#.#
#.#.#.#.####.#.#.#.#
#.#.#.#.####.#.#.#.#
#.#.#..........#.#.#
#.#.############.#.#
#o................o#
####################
