####################
#o................o#
#.###.########.###.#
#..................#
#.#####.####.#####.#
#.#..............#.#
#...###.####.###...#
###.#...####...#.###
......#......#......
###.#...####...#.###
#...###.####.###...#
#.#..............#.#
#.#####.####.#####.#
#..................#
#.###.########.###.#
#o................o#
####################
