####################
#o................o#
#.#####.####.#####.#
#.#####.####.#####.#
#..................#
#.################.#
#..................#
###.###.##.###.#####
....###.##.###......
###.###.##.###.#####
#..................#
#.################.#
#.......####.......#
#.#####......#####.#
#.#####.####.#####.#
#o................o#
####################
